Purportedly - Väidetavalt
Per_se - Per_se
Paramount - Paramount
Somber - Somber
Indigenous - Põlisrahvas
Designation - Määramine
Plausible - Usutav
Tenement - Tenement
To resemble - Et sarnaneda
Tenant - Üürnik
To frown - Kulmu kortsutama
To cow - Lehmale
Hypochondria - Hüpohondria
To pester - Ärritama
To slink down the stairs - Trepist alla laskumiseks
To ramble - Rammuma
Slake - Slake
To scaffold - Tellingutele
Stench - Stench
Loathsome - Vaenukas
Repugnance - Tagasilükkamine
Flicker - Virvendus
Brooding - Sordid
Oblivion - Unustus
To inure - Ravida
Contempt - Põlgus
Finickiness - Valmisolek
Convulsively - Krambilikult
Brim - Ääreni
To assail someone - Kellegi ründamiseks
Akin to something - Akin millekski
To mutter - Mõista
Conspicuous - Silmatorkav
Inquisitive - Uudishimulik
Barred by something - Midagi keelab
Brass - Messing
Hostile - Vaenulik
To smear with something - Midagi määrida
Flannel - Flanell
Erstwhile - Vahepeal
Geraniums - Geraniums
He reflected - Ta kajastas
Dubious - Kahtlane
Decidedly - Otsustatud
Debility - Debiilsus
Notwithstanding - Vaatamata sellele
Concertina - Concertina
Caftan - Caftan
Agitation - Agitatsioon
Whereupon - Milleks
Foreknowledge - Eelteadmised
To ascribe - Et määrata
Incessantly - Lakkamatult
Proprieties - Proprieties
Luminous - Helendav
To protrude - Väljaulatuvaks
Bespoke - Eritellimusel
Trodden the path of - Trodden tee
To pounce upon - Süütama
Destitution - Sihtkoht
Oleganious - Olegaaniline
Indolent - Laisk
Snigger - Snigger
Penchant - Penchant
Flowery - Lilleline
Reptilian - Roomaja
To unruffle - Lahti harutada
To confound - Segaduses
Resignation - Tagasiastumine
Magnanimous - Suurejooneline
To tug - Pukseerima
In vain - Asjatult
Proclivity - Prokliatiivsus
Barter - Barter
Revelry - Revelry
Incessant - Lakkamatu
Strife - Tüli
Bygone - Möödunud
Indomitable - Sundimatu
Coarse - Jäme
Infantry - Jalavägi
To reproach - Noomida
Brutish - Jõhker
To wringe - Et vingerdada
Piously - Armulikult
Devoutly - Ausalt
Abstemiousness - Südamlikkus
Adorned - Kaunistatud
On the pretext that - Selle ettekäändel
Ill-intentioned - Ebasoovitav
Inauspicious - Ebasoodne
For another - Teise jaoks
Meek - Armas
Melteth - Sulab
Audible - Kuuldav
Radiance - Kiirgus
Frivolous - Kerge
Foible - Foible
To render - Muuta
To indulge - Anduma
Condemn - Hukka mõista
Spasmodically - Spasmiliselt
Debauchery - Debauchery
Transient - Mööduv
Reverie - Unistamine
To filch - Filchima
Apparel - Kehakate
Insolence - Insolentsus
To enunciate - Kujutada
To crucify - Risti lüüa
Mortification - Mortifikatsioon
Merrymaking - Rõõmsameelne
Partaken - Omandatud
Consumptive - Tarbiv
To slump - Et madaldaks
The door had been left ajar - Uks oli lahti tehtud
Scarlet - Scarlet
To glitter - Särama
Axiom - Aksioom
To smear with something - Midagi määrida
Revulsion - Revulsion
To barter - Barteri juurde
To lurch - Laskma
Scullery - Vits
To ensconce - Et end kokku lüüa
To exhibit - Näitamiseks
Stout - Stout
To tush - Pingutama
Cud - Kais
Lest there should be - Lest seal peaks olema
Foal - Vars
Mare - Mare
Feeble - Feeble
Hideous - Varjatud
Dwell upon something - Maha midagi
To abolish - Kaotada
Plough - Künd
Dung - Sõnnik
To till - Kuni
Foal - Vars
Confinement - Sünnitamine
Rations - Ratsioonid
Knacker - Koputaja
Trotterclime - Trotterclime
Pellets - Graanulid
Dissentient - Teadmatu
Enmity - Vaenu
Hoarse - Kähe
Eminent - Väljapaistev
Pre-eminemt - Preeminent
Fierce - Äge
Vivacious - Elav
Shrill - Shrill
Clover - Ristik
Hedge - Hekk
To neglect - Unarusse jätta
To lounge - Salongisse
Pasture - Karjamaa
To gambol - Gamboli juurde
Lithograph - Litograafia
Mantelpiece - Tüdruk
Commandment - Käsk
To toil - Töötama
Hind legs - Tagajalad
To mow - Niita
To harness - Rakmete külge
Acute - Äge
Dole out - Dole välja
Cockerel - Kukal
Quarrel - Tüli
Obstinate - Kahtlane
Indefatigable - Väsimatu
To tame - Taltsutama
Literate - Kirjaoskus
Maxim - Maksim
To whelp - Varisema
Seclusion - Üksindus
To wean - Võõrutama
To murmur - Nuriseda
Pleadingly - Ausalt
To bargain - Kauplema
Shrewd - Kohutav
To devour - Õgima
Contemptible - Taunitav
Irrepressible - Ilmutamatu
To tremble - Värisema
To skirmish - Jaoks
To retreat - Taanduma
To prod - Prod
Ignominious - Süütamatu
To gore - Goreerida
Reassemble - Pange uuesti kokku
Posthumously - Postuumselt
Cartridge - Kassett
Blithely - Blithely
To prance - Prantsuse poole
To ratify - Ratifitseerida
Canvassing - Lõuend
To bide - Paugutama
To conjure - Võluda
To quarry - Karjäärisse
Faction - Fraktsioon
Restive - Restive
Procure - Hange
Sordid - Sordid
To preside - Juhatada
Expulsion - Väljasaatmine
To marshal - Marssalini
To menace - Et ähvardada
To disinter - Et hajutada
Reverent - Austusväärne
To disperse - Hajutada
Cunning - Kavalus
Sly - Kaval
Arable - Põllukultuur
Solicitor - Advokaat
To reconcile - Leppida
Sty - Sty
To marvel - Imetlema
To impose - Sundida
Gale - Gale
Malignity - Pahaloomulisus
Bushel - Bushel
Rejoice - Rõõmustage
Out of spite - Vaatamata
Chaff - Tibu
Mangels - Mangelid
Embolden - Embolden
Infanticide - Infantitsiid
Hitherto - Seni
Procure - Hange
To growl - Urisema
Clutches - Sidurid
Expulsion - Väljasaatmine
Outcry - Pahandamine
Pullet - Kärntõbi
Thrawt - Ära
Rafter - Sarikad
To devreed - Pühenduda
Duly - Nõuetekohaselt
Timber - Puit
Gnawed - Näritud
Snout - Kärss
To stupefy - Lollitada
To tuck - Tupsutama
Hoofs - Kabjad
To graze - Karjatada
To frisk - Mõtlema
Sternly - Sternly
To seize - Kinni haarata
Whimper - Vingumine
Countenance - Hooldus
Whereat - Kus
Tumult - Tumult
Promptly - Viivitamatult
Knoll - Knoll
To incite - Õhutada
Retribution - Tasumine
To huddle - Kihutama
To lumber - Lepama
Trot - Traav
To and fro - Sinna-tänna
Overthrow - Kukuta
Pellet - Pellet
To fetch - Tooda
All the same - Kõik on sama
Fortnight - Kaks nädalat
Retinue - Tagastama
Cockerel - Kukal
As well as - Sama hästi kui
To surmount - Ületada
To skulk - Et skulk
Lest - Lest
To impend - Imendama
To flog - Ubisema
Furnace - Kolle
To clamour - Kärama
To counsel - Nõustada
Scoundrel - Harakas
Machination - Machineerimine
Gander - Gander
Privy - Privaatne
Hitherto - Seni
Bewilderment - Segadused
Punctually - Täpselt
Forsook - Forsook
To gambol - Gamboli juurde
Cunning - Kavalus
Beatifically - Lustiliselt
To rustle - Röstima
Sentinel - Sentinel
Conciliatory - Lepitav
To sally - Sally juurde
To pencil - Pliiatsiks
Crowbar - Crowbar
Dismay - Hämming
Intently - Tahtlikult
Venture - Ettevõtmine
Vile - Vile
Contemptible - Taunitav
Heed - Kuule
To unscathe - Lõikamata
Ferociously - Metsikult
To fore - Esiplaanile
Detour - Ümbersõit
Thorn - Okas
Weary - Väsinud
To smart - Nutikaks
Procession - Rongkäik
To confer - Anda
Dejectedly - Sundimatult
Lamentation - Lusta
To contrive - Arvata
Paddock - Paddock
To sprawl - Laialivalguda
Enmity - Vaenu
Orchard - Viljapuuaed
To neglect - Unarusse jätta
Obstinate - Kahtlane
Propulsion - Tõukejõud
Superintendence - Juhataja
Arable - Põllukultuur
To repose - Et tagasi lüüa
Dejectedly - Sundimatult
